%%%%%%%%%%%%%%%%%%%%%%%%%%%%%%%
%.%.........%% G %   %%%%.....%
%.%.%%%%%%%.%%%%%% %%%%%%%.%%.%
%............%...%............%
%%%%%...%%%..     ..%.%...%.%%%
% %%%.%%%%%.%%%%%%%.%%%.%.%%%%%
%    ..........P ...%...%.    %
%%%%%%%%%%%%%%%%%%%%%%%%%%%%%%%
