%%%%%%%%%%%%%%%%%%%%
% ...%........%... %
%.%%.%.%%..%%.%.%%.%
%...... G GG%......%
%.%.%%.%% %%%.%%.%.%
%.%....%    %.%..%.%
%.%.%%.% %% %.%.%%.%
% %......P....%....%
%%%%%%%%%%%%%%%%%%%%
