%%%%%%%%%%%%%%%%%%%%%%%%%%%%%%%
%.%     ....%% G %%%%%%    %%.%
%.% %%%%%%%.%%%%%%%     %%%%%.%
% %%%.%%%%%.%%%%%%%.%%%.%.%%%.%
%    ..........P ...%.........%
%%%%%%%%%%%%%%%%%%%%%%%%%%%%%%%
