%%%%%%%%%%%%%%%%%%%%
% .... %GGGG% .... %
%..%...%%  %%...%..%
%.% .%........%. %.%
%. %.%.%%%%%%.%.% .%
%........P.........%
%%%%%%%%%%%%%%%%%%%%
