%%%%%%%%%
%.. % G %
%%% %%%%%
%       %
%%%%%%% %
%       %
% %%%%% %
%     % %
%%%%% % %
%     % %
% %%%%%%%
%      .%
%%%%%%%.%
%P     .%
%%%%%%%%%
