%%%%%%%%%
% G %...%
%%%%%%% %
%P      %
%.%%.%%.%
%.%%....%
%%%%%%%%%
